********************************************************************************************************************,
**/\/\/\/\/\/\                                                                                                    **,
**!          !                                                                                                    **,
**!          !                                                                                                    **,
**!          !                                                                                                    **,
**!          !                                                                                                    **,
**!          !                                                                                                    **,
**!          !                                                                                                    **,
**!          !                                                                                                    **,
**!          !                                                                                                    **,
**!          !                                                                                                    **,
**!          !                                                                                                    **,
**!          !                                                                                                    **,
**!          !                                                                                                    **,
**!          !                                                                                                    **,
**!          !                                                                                                    **,
**!          !                                                                                                    **,
**!          !                                                                                                    **,
**!          !                                                                                                    **,
**!          !                                                                                                    **,
**!          !                                                                                                    **,
**!          !                                                                                                    **,
**!          !                                                                                                    **,
**!          !                                                                                                    **,
**!          !                                                                                                    **,
**!          !                                                                                                    **,
**!          !                                                                                                    **,
**!          !                                                                                                    **,
**!          !                                                                                                    **,
********************************************************************************************************************,